"adm3","n_household","population","male","female","adm2"
"板橋區",218481,556475,270434,286041,"新北市"
"三重區",154901,384124,188344,195780,"新北市"
"中和區",169188,410032,198154,211878,"新北市"
"永和區",91885,218836,103643,115193,"新北市"
"新莊區",161767,423081,206127,216954,"新北市"
"新店區",130551,302753,145117,157636,"新北市"
"樹林區",67584,182977,91148,91829,"新北市"
"鶯歌區",32041,87739,43937,43802,"新北市"
"三峽區",44651,116755,58345,58410,"新北市"
"淡水區",83735,184106,88014,96092,"新北市"
"汐止區",91523,205883,100167,105716,"新北市"
"瑞芳區",16168,38857,19605,19252,"新北市"
"土城區",89885,238247,117105,121142,"新北市"
"蘆洲區",73693,202507,99077,103430,"新北市"
"五股區",34951,89812,45128,44684,"新北市"
"泰山區",29011,78100,38531,39569,"新北市"
"林口區",49544,122561,59570,62991,"新北市"
"深坑區",9836,23768,11891,11877,"新北市"
"石碇區",3395,7493,4091,3402,"新北市"
"坪林區",2554,6689,3637,3052,"新北市"
"三芝區",9604,22498,11548,10950,"新北市"
"石門區",4231,11367,5908,5459,"新北市"
"八里區",15720,39731,19811,19920,"新北市"
"平溪區",2240,4379,2446,1933,"新北市"
"雙溪區",3705,8370,4548,3822,"新北市"
"貢寮區",4344,11689,5971,5718,"新北市"
"金山區",7213,21016,10322,10694,"新北市"
"萬里區",7548,21554,10776,10778,"新北市"
"烏來區",1909,6331,3108,3223,"新北市"
"松山區",80784,198603,92767,105836,"臺北市"
"信義區",88538,212559,100923,111636,"臺北市"
"大安區",120800,299823,139592,160231,"臺北市"
"中山區",100571,221679,102668,119011,"臺北市"
"中正區",65691,154461,73471,80990,"臺北市"
"大同區",52340,123334,59715,63619,"臺北市"
"萬華區",79192,181044,88532,92512,"臺北市"
"文山區",107724,266439,127265,139174,"臺北市"
"南港區",47955,117777,57388,60389,"臺北市"
"內湖區",110026,280785,133752,147033,"臺北市"
"士林區",107910,275823,132837,142986,"臺北市"
"北投區",98160,248679,119257,129422,"臺北市"
"桃園區",179193,458405,221394,237011,"桃園市"
"中壢區",162367,422635,206989,215646,"桃園市"
"大溪區",34201,95352,48431,46921,"桃園市"
"楊梅區",63311,175795,88178,87617,"桃園市"
"蘆竹區",61509,166800,82514,84286,"桃園市"
"大園區",35847,93857,47749,46108,"桃園市"
"龜山區",66439,165141,81885,83256,"桃園市"
"八德區",76724,209234,104009,105225,"桃園市"
"龍潭區",44337,124366,61958,62408,"桃園市"
"平鎮區",81448,228609,113131,115478,"桃園市"
"新屋區",17378,49250,26168,23082,"桃園市"
"觀音區",25173,69182,35769,33413,"桃園市"
"復興區",3851,12345,6644,5701,"桃園市"
"中區",7955,18049,8930,9119,"臺中市"
"東區",28940,75646,37406,38240,"臺中市"
"南區",50393,126654,60499,66155,"臺中市"
"西區",46383,114318,54138,60180,"臺中市"
"北區",60728,146096,69600,76496,"臺中市"
"西屯區",90378,231700,110918,120782,"臺中市"
"南屯區",67399,176796,84322,92474,"臺中市"
"北屯區",108929,289104,137913,151191,"臺中市"
"豐原區",55258,165745,81645,84100,"臺中市"
"東勢區",17492,48948,25054,23894,"臺中市"
"大甲區",23891,75953,38101,37852,"臺中市"
"清水區",29558,88163,45004,43159,"臺中市"
"沙鹿區",31469,95304,47934,47370,"臺中市"
"梧棲區",19151,59432,29760,29672,"臺中市"
"后里區",16844,54236,27432,26804,"臺中市"
"神岡區",20228,65288,33266,32022,"臺中市"
"潭子區",37616,109225,53817,55408,"臺中市"
"大雅區",30685,95694,47554,48140,"臺中市"
"新社區",7763,23940,12358,11582,"臺中市"
"石岡區",4958,14579,7507,7072,"臺中市"
"外埔區",9971,31824,16224,15600,"臺中市"
"大安區",5637,18753,9907,8846,"臺中市"
"烏日區",26802,76856,38399,38457,"臺中市"
"大肚區",18423,56614,28829,27785,"臺中市"
"龍井區",24387,78159,39262,38897,"臺中市"
"霧峰區",20886,64913,32849,32064,"臺中市"
"太平區",68171,195237,96367,98870,"臺中市"
"大里區",72961,212944,104168,108776,"臺中市"
"和平區",4650,10809,5800,5009,"臺中市"
"新營區",29483,76209,37619,38590,"臺南市"
"鹽水區",10156,24943,12998,11945,"臺南市"
"白河區",10728,27095,14150,12945,"臺南市"
"柳營區",8003,20780,10806,9974,"臺南市"
"後壁區",8786,22628,11723,10905,"臺南市"
"東山區",8244,19993,10656,9337,"臺南市"
"麻豆區",16096,43666,22164,21502,"臺南市"
"下營區",9377,23326,12059,11267,"臺南市"
"六甲區",7932,21590,11173,10417,"臺南市"
"官田區",8132,21164,10763,10401,"臺南市"
"大內區",3728,9154,4937,4217,"臺南市"
"佳里區",21224,58706,28985,29721,"臺南市"
"學甲區",9773,25202,12907,12295,"臺南市"
"西港區",8479,24519,12383,12136,"臺南市"
"七股區",7943,22072,11445,10627,"臺南市"
"將軍區",7198,18973,9663,9310,"臺南市"
"北門區",4124,10511,5270,5241,"臺南市"
"新化區",14872,43162,21912,21250,"臺南市"
"善化區",19386,50961,25676,25285,"臺南市"
"新市區",13358,37695,18891,18804,"臺南市"
"安定區",10528,30294,15605,14689,"臺南市"
"山上區",2721,7074,3727,3347,"臺南市"
"玉井區",5164,13518,6996,6522,"臺南市"
"楠西區",3489,9124,4802,4322,"臺南市"
"南化區",2821,8329,4497,3832,"臺南市"
"左鎮區",1909,4526,2558,1968,"臺南市"
"仁德區",28665,76127,38459,37668,"臺南市"
"歸仁區",23400,68122,34422,33700,"臺南市"
"關廟區",11568,33995,17424,16571,"臺南市"
"龍崎區",1499,3736,2026,1710,"臺南市"
"永康區",87997,235451,115582,119869,"臺南市"
"東區",73153,184310,88040,96270,"臺南市"
"南區",47245,123166,60729,62437,"臺南市"
"北區",51773,129444,62719,66725,"臺南市"
"安南區",66489,196034,98558,97476,"臺南市"
"安平區",27032,67237,31834,35403,"臺南市"
"中西區",32456,78388,37787,40601,"臺南市"
"鹽埕區",10858,23389,11550,11839,"高雄市"
"鼓山區",60159,141336,67838,73498,"高雄市"
"左營區",81192,197215,94222,102993,"高雄市"
"楠梓區",74926,189728,92714,97014,"高雄市"
"三民區",138966,335915,161896,174019,"高雄市"
"新興區",23163,50255,24100,26155,"高雄市"
"前金區",12997,26580,12546,14034,"高雄市"
"苓雅區",73164,166684,79732,86952,"高雄市"
"前鎮區",79430,184939,90510,94429,"高雄市"
"旗津區",11004,27610,14195,13415,"高雄市"
"小港區",69448,156737,77492,79245,"高雄市"
"鳳山區",144983,359054,175166,183888,"高雄市"
"林園區",26791,69269,34817,34452,"高雄市"
"大寮區",43465,112168,57230,54938,"高雄市"
"大樹區",13904,41617,21276,20341,"高雄市"
"大社區",13305,34239,17382,16857,"高雄市"
"仁武區",37049,92249,46562,45687,"高雄市"
"鳥松區",19226,44844,22613,22231,"高雄市"
"岡山區",35634,96710,47817,48893,"高雄市"
"橋頭區",15167,39136,19695,19441,"高雄市"
"燕巢區",10760,29353,15432,13921,"高雄市"
"田寮區",3129,6873,3799,3074,"高雄市"
"阿蓮區",9476,28245,14258,13987,"高雄市"
"路竹區",17385,51616,26181,25435,"高雄市"
"湖內區",11170,29812,15151,14661,"高雄市"
"茄萣區",10673,29912,15306,14606,"高雄市"
"永安區",5763,13629,6830,6799,"高雄市"
"彌陀區",6817,18816,9608,9208,"高雄市"
"梓官區",12951,35413,18193,17220,"高雄市"
"旗山區",13712,35607,18286,17321,"高雄市"
"美濃區",14912,38360,20175,18185,"高雄市"
"六龜區",5456,12312,6648,5664,"高雄市"
"甲仙區",2288,5830,3088,2742,"高雄市"
"杉林區",4750,11425,6222,5203,"高雄市"
"內門區",5131,13916,7526,6390,"高雄市"
"茂林區",611,1891,951,940,"高雄市"
"桃源區",1369,4194,2200,1994,"高雄市"
"那瑪夏區",861,3150,1625,1525,"高雄市"
"宜蘭市",37181,95293,46344,48949,"宜蘭縣"
"羅東鎮",26782,71426,33669,37757,"宜蘭縣"
"蘇澳鎮",14415,38696,19709,18987,"宜蘭縣"
"頭城鎮",10459,28737,14777,13960,"宜蘭縣"
"礁溪鄉",14430,35154,18199,16955,"宜蘭縣"
"壯圍鄉",9197,24400,12791,11609,"宜蘭縣"
"員山鄉",12039,32170,16978,15192,"宜蘭縣"
"冬山鄉",19859,52981,27056,25925,"宜蘭縣"
"五結鄉",15733,40264,20617,19647,"宜蘭縣"
"三星鄉",8872,21207,11396,9811,"宜蘭縣"
"大同鄉",1977,6083,3281,2802,"宜蘭縣"
"南澳鄉",2026,5944,3078,2866,"宜蘭縣"
"竹北市",75431,202783,100882,101901,"新竹縣"
"關西鎮",9348,27647,14873,12774,"新竹縣"
"新埔鎮",11412,33007,17573,15434,"新竹縣"
"竹東鎮",35468,96911,48800,48111,"新竹縣"
"湖口鄉",28860,79187,40051,39136,"新竹縣"
"橫山鄉",4392,12474,6772,5702,"新竹縣"
"新豐鄉",19520,57609,29526,28083,"新竹縣"
"芎林鄉",6896,19873,10510,9363,"新竹縣"
"寶山鄉",6001,14574,7939,6635,"新竹縣"
"北埔鄉",3129,8969,4892,4077,"新竹縣"
"峨眉鄉",2082,5363,2956,2407,"新竹縣"
"尖石鄉",2927,9574,4980,4594,"新竹縣"
"五峰鄉",1764,4451,2407,2044,"新竹縣"
"苗栗市",32324,87507,43581,43926,"苗栗縣"
"頭份市",37469,104745,52753,51992,"苗栗縣"
"苑裡鎮",15043,44498,23213,21285,"苗栗縣"
"通霄鎮",11571,32808,17352,15456,"苗栗縣"
"竹南鎮",31450,87270,44035,43235,"苗栗縣"
"後龍鎮",12093,35021,18539,16482,"苗栗縣"
"卓蘭鎮",5910,16081,8424,7657,"苗栗縣"
"大湖鄉",5266,13776,7353,6423,"苗栗縣"
"公館鄉",10835,32247,16810,15437,"苗栗縣"
"銅鑼鄉",6114,17121,9094,8027,"苗栗縣"
"南庄鄉",3893,9468,5211,4257,"苗栗縣"
"頭屋鄉",3614,10159,5387,4772,"苗栗縣"
"三義鄉",5645,15576,8246,7330,"苗栗縣"
"西湖鄉",2635,6661,3739,2922,"苗栗縣"
"造橋鄉",4141,12134,6439,5695,"苗栗縣"
"三灣鄉",2338,6310,3442,2868,"苗栗縣"
"獅潭鄉",1723,4121,2290,1831,"苗栗縣"
"泰安鄉",1991,5723,3086,2637,"苗栗縣"
"彰化市",78166,230366,113288,117078,"彰化縣"
"員林市",41039,123738,61226,62512,"彰化縣"
"鹿港鎮",25338,86286,43792,42494,"彰化縣"
"和美鎮",27551,89927,45764,44163,"彰化縣"
"北斗鎮",11118,33344,16747,16597,"彰化縣"
"溪湖鎮",16730,54666,27656,27010,"彰化縣"
"田中鎮",13405,40532,20783,19749,"彰化縣"
"二林鎮",15287,49470,25338,24132,"彰化縣"
"線西鄉",4540,16597,8546,8051,"彰化縣"
"伸港鄉",10591,37747,19071,18676,"彰化縣"
"福興鄉",13244,46150,24054,22096,"彰化縣"
"秀水鄉",11155,38841,20000,18841,"彰化縣"
"花壇鄉",14457,45073,23125,21948,"彰化縣"
"芬園鄉",6826,23012,12130,10882,"彰化縣"
"大村鄉",11752,38946,19880,19066,"彰化縣"
"埔鹽鄉",9321,31826,16704,15122,"彰化縣"
"埔心鄉",10946,34283,17598,16685,"彰化縣"
"永靖鄉",11118,36170,18716,17454,"彰化縣"
"社頭鄉",13172,42293,21731,20562,"彰化縣"
"二水鄉",5289,14544,7671,6873,"彰化縣"
"田尾鄉",8143,26611,13750,12861,"彰化縣"
"埤頭鄉",9184,29960,15444,14516,"彰化縣"
"芳苑鄉",10135,32523,17165,15358,"彰化縣"
"大城鄉",5166,15984,8616,7368,"彰化縣"
"竹塘鄉",4595,14733,7723,7010,"彰化縣"
"溪州鄉",9046,29051,15179,13872,"彰化縣"
"南投市",35526,99018,49465,49553,"南投縣"
"埔里鎮",29082,78986,39205,39781,"南投縣"
"草屯鎮",34112,97325,48998,48327,"南投縣"
"竹山鎮",20317,53225,27195,26030,"南投縣"
"集集鎮",4252,10381,5441,4940,"南投縣"
"名間鄉",12661,37327,19661,17666,"南投縣"
"鹿谷鄉",7983,17100,9128,7972,"南投縣"
"中寮鄉",5574,14195,7749,6446,"南投縣"
"魚池鄉",5734,15331,8091,7240,"南投縣"
"國姓鄉",7176,17812,9622,8190,"南投縣"
"水里鄉",7094,16878,8862,8016,"南投縣"
"信義鄉",5269,15811,8462,7349,"南投縣"
"仁愛鄉",4831,15759,8089,7670,"南投縣"
"斗六市",39541,108632,53854,54778,"雲林縣"
"斗南鎮",16160,43949,22283,21666,"雲林縣"
"虎尾鎮",26019,70819,35771,35048,"雲林縣"
"西螺鎮",15082,45305,22750,22555,"雲林縣"
"土庫鎮",9580,28188,14709,13479,"雲林縣"
"北港鎮",16117,38908,20105,18803,"雲林縣"
"古坑鄉",11290,30720,16144,14576,"雲林縣"
"大埤鄉",6666,18564,9867,8697,"雲林縣"
"莿桐鄉",9472,28186,14678,13508,"雲林縣"
"林內鄉",6012,17453,9143,8310,"雲林縣"
"二崙鄉",8970,25900,13853,12047,"雲林縣"
"崙背鄉",8617,23753,12531,11222,"雲林縣"
"麥寮鄉",15153,47911,23795,24116,"雲林縣"
"東勢鄉",5800,14039,7784,6255,"雲林縣"
"褒忠鄉",4437,12398,6667,5731,"雲林縣"
"臺西鄉",8525,22856,12240,10616,"雲林縣"
"元長鄉",9122,24550,13436,11114,"雲林縣"
"四湖鄉",8649,22186,12100,10086,"雲林縣"
"口湖鄉",9364,26264,14024,12240,"雲林縣"
"水林鄉",9637,24041,13126,10915,"雲林縣"
"太保市",13714,38650,19676,18974,"嘉義縣"
"朴子市",15900,41569,20946,20623,"嘉義縣"
"布袋鎮",9827,25843,13168,12675,"嘉義縣"
"大林鎮",11421,30303,15415,14888,"嘉義縣"
"民雄鄉",25796,71173,36354,34819,"嘉義縣"
"溪口鄉",5264,13956,7427,6529,"嘉義縣"
"新港鄉",10833,31031,16370,14661,"嘉義縣"
"六腳鄉",8745,22041,11683,10358,"嘉義縣"
"東石鄉",9093,23625,12501,11124,"嘉義縣"
"義竹鄉",7244,17490,9129,8361,"嘉義縣"
"鹿草鄉",5734,14840,7960,6880,"嘉義縣"
"水上鄉",18479,48835,25232,23603,"嘉義縣"
"中埔鄉",16147,43974,22783,21191,"嘉義縣"
"竹崎鄉",11704,34583,18400,16183,"嘉義縣"
"梅山鄉",6746,18575,9866,8709,"嘉義縣"
"番路鄉",4237,11121,5981,5140,"嘉義縣"
"大埔鄉",1932,4558,2329,2229,"嘉義縣"
"阿里山鄉",1880,5474,2879,2595,"嘉義縣"
"屏東市",75219,197049,96980,100069,"屏東縣"
"潮州鎮",20259,53874,26782,27092,"屏東縣"
"東港鎮",17189,46699,23543,23156,"屏東縣"
"恆春鎮",11928,30320,15531,14789,"屏東縣"
"萬丹鄉",15610,50018,25921,24097,"屏東縣"
"長治鄉",10362,29371,15236,14135,"屏東縣"
"麟洛鄉",3891,10736,5553,5183,"屏東縣"
"九如鄉",7325,21830,11203,10627,"屏東縣"
"里港鄉",8297,25669,13024,12645,"屏東縣"
"鹽埔鄉",7929,24877,12915,11962,"屏東縣"
"高樹鄉",9187,23644,12549,11095,"屏東縣"
"萬巒鄉",6565,20085,10448,9637,"屏東縣"
"內埔鄉",19069,53045,27250,25795,"屏東縣"
"竹田鄉",5661,16458,8742,7716,"屏東縣"
"新埤鄉",3426,9496,5058,4438,"屏東縣"
"枋寮鄉",8647,23572,12318,11254,"屏東縣"
"新園鄉",11872,33725,17503,16222,"屏東縣"
"崁頂鄉",4548,15296,7670,7626,"屏東縣"
"林邊鄉",6674,17143,8740,8403,"屏東縣"
"南州鄉",3793,10315,5284,5031,"屏東縣"
"佳冬鄉",6991,18538,9577,8961,"屏東縣"
"琉球鄉",4691,12143,6613,5530,"屏東縣"
"車城鄉",3497,8230,4388,3842,"屏東縣"
"滿州鄉",3030,7419,4030,3389,"屏東縣"
"枋山鄉",2044,5168,2730,2438,"屏東縣"
"三地門鄉",2359,7709,3887,3822,"屏東縣"
"霧臺鄉",1083,3237,1663,1574,"屏東縣"
"瑪家鄉",2080,6750,3414,3336,"屏東縣"
"泰武鄉",1416,5346,2791,2555,"屏東縣"
"來義鄉",2262,7411,3700,3711,"屏東縣"
"春日鄉",1434,4930,2510,2420,"屏東縣"
"獅子鄉",1610,4817,2476,2341,"屏東縣"
"牡丹鄉",1974,4845,2425,2420,"屏東縣"
"臺東市",40366,104577,52089,52488,"臺東縣"
"成功鎮",5343,13439,7070,6369,"臺東縣"
"關山鎮",3211,8372,4328,4044,"臺東縣"
"卑南鄉",6864,16917,8903,8014,"臺東縣"
"大武鄉",2461,5679,2967,2712,"臺東縣"
"太麻里鄉",4812,10864,5770,5094,"臺東縣"
"東河鄉",3705,8155,4496,3659,"臺東縣"
"長濱鄉",2898,6870,3871,2999,"臺東縣"
"鹿野鄉",3017,7556,3990,3566,"臺東縣"
"池上鄉",3178,8054,4150,3904,"臺東縣"
"綠島鄉",1179,4085,2180,1905,"臺東縣"
"延平鄉",1066,3554,1895,1659,"臺東縣"
"海端鄉",1088,4128,2183,1945,"臺東縣"
"達仁鄉",1418,3467,1873,1594,"臺東縣"
"金峰鄉",1181,3675,1849,1826,"臺東縣"
"蘭嶼鄉",1944,5207,2611,2596,"臺東縣"
"花蓮市",41827,102205,49077,53128,"花蓮縣"
"鳳林鎮",4393,10796,5595,5201,"花蓮縣"
"玉里鎮",8914,23232,12295,10937,"花蓮縣"
"新城鄉",7860,20013,10180,9833,"花蓮縣"
"吉安鄉",32886,83434,41774,41660,"花蓮縣"
"壽豐鄉",7356,17467,9292,8175,"花蓮縣"
"光復鄉",4984,12318,6558,5760,"花蓮縣"
"豐濱鄉",1683,4360,2444,1916,"花蓮縣"
"瑞穗鄉",4798,11276,6042,5234,"花蓮縣"
"富里鄉",4051,9945,5397,4548,"花蓮縣"
"秀林鄉",4945,16186,8310,7876,"花蓮縣"
"萬榮鄉",2119,6204,3273,2931,"花蓮縣"
"卓溪鄉",1704,6005,3285,2720,"花蓮縣"
"馬公市",25787,63238,32140,31098,"澎湖縣"
"湖西鄉",6095,15212,8052,7160,"澎湖縣"
"白沙鄉",3561,9877,5092,4785,"澎湖縣"
"西嶼鄉",3078,8311,4273,4038,"澎湖縣"
"望安鄉",2081,5400,2928,2472,"澎湖縣"
"七美鄉",1461,3867,1979,1888,"澎湖縣"
"中正區",22877,51073,25944,25129,"基隆市"
"七堵區",21924,53639,26818,26821,"基隆市"
"暖暖區",16089,38549,19269,19280,"基隆市"
"仁愛區",18985,42675,21027,21648,"基隆市"
"中山區",19225,46249,23435,22814,"基隆市"
"安樂區",34068,81733,40431,41302,"基隆市"
"信義區",22597,53170,26115,27055,"基隆市"
"東區",84222,221025,108857,112168,"新竹市"
"北區",59224,152502,74346,78156,"新竹市"
"香山區",28588,78702,39989,38713,"新竹市"
"東區",45914,119431,57162,62269,"嘉義市"
"西區",55380,145985,71138,74847,"嘉義市"
"金城鎮",13148,42827,21344,21483,"金門縣"
"金湖鎮",9410,30357,15209,15148,"金門縣"
"金沙鎮",6475,20679,10189,10490,"金門縣"
"金寧鄉",9475,33136,16644,16492,"金門縣"
"烈嶼鄉",3241,12661,6294,6367,"金門縣"
"烏坵鄉",133,665,341,324,"金門縣"
"南竿鄉",1949,7659,4323,3336,"連江縣"
"北竿鄉",819,2792,1610,1182,"連江縣"
"莒光鄉",321,1490,928,562,"連江縣"
"東引鄉",355,1462,892,570,"連江縣"
